0,0,0,0,0,0,0,0,0,0,0,0,0
0,0,0,0,0,0,0,0,0,0,0,0,0
0,0,0,0,0,0,0,0,0,0,0,0,0
0,0,0,0,0,0,0,0,0,0,0,0,0
0,0,0,0,0,0,0,0,0,0,0,0,0
0,109,109,2,2,2,2,2,2,2,109,109,0
102,103,103,104,104,104,104,104,104,104,103,103,102
108,108,108,108,108,108,108,108,108,108,108,108,108
102,103,103,108,108,108,108,108,108,108,103,103,102
104,109,109,104,104,104,104,104,104,104,109,109,104
104,101,101,2,2,2,2,2,2,2,101,101,104
104,101,101,2,2,2,2,2,2,2,101,101,104
0,101,101,2,2,2,2,2,2,2,101,101,0
