0,0,0,0,0,0,0,0,0,0,0,0,0
0,0,0,0,0,0,0,0,0,0,0,0,0
0,2,2,2,0,2,2,2,0,2,2,2,0
0,2,106,2,0,2,103,2,0,2,102,2,0
0,2,106,2,0,2,103,2,0,2,102,2,0
0,2,2,2,0,2,2,2,0,2,2,2,0
18,0,0,0,0,0,0,0,0,0,0,0,18
0,2,2,2,0,18,18,18,0,2,2,2,0
0,2,104,2,0,2,101,2,0,2,2,2,0
0,2,104,2,0,2,101,2,0,2,2,2,0
0,2,2,2,0,18,18,18,0,2,2,2,0
18,0,0,0,0,0,0,0,0,0,0,0,18
0,18,2,18,0,2,2,2,0,18,2,18,0
0,18,109,18,0,2,108,2,0,18,109,18,0
0,18,109,18,0,2,108,2,0,18,109,18,0
0,18,2,18,0,2,2,2,0,18,2,18,0
