0,0,0,0,0,0,0,0,0,0,0,0,0
0,0,0,0,0,0,0,0,0,0,0,0,0
101,101,101,101,101,101,101,101,101,101,101,101,101
101,101,101,101,101,101,101,101,101,101,101,101,101
0,101,101,0,0,0,0,0,0,0,101,101,0
0,101,101,0,0,0,0,0,0,0,101,101,0
0,0,101,101,0,0,0,0,0,101,101,0,0
0,0,101,101,0,0,0,0,0,101,101,0,0
0,0,0,101,101,0,0,0,101,101,0,0,0
0,0,0,101,101,0,0,0,101,101,0,0,0
0,0,0,0,101,101,0,101,101,0,0,0,0
0,0,0,0,101,101,0,101,101,0,0,0,0
0,0,0,0,0,101,101,101,0,0,0,0,0
0,0,0,0,0,101,101,101,0,0,0,0,0
0,0,0,0,0,0,101,0,0,0,0,0,0
0,0,0,0,0,0,101,0,0,0,0,0,0
0,0,0,0,0,0,0,0,0,0,0,0,0
0,0,0,0,0,0,0,0,0,0,0,0,0
0,0,0,0,0,0,0,0,0,0,0,0,0
0,0,0,0,0,0,0,0,0,0,0,0,0
