0,0,0,0,0,0,0,0,0,0,0,0,0
0,0,0,0,0,0,0,2,109,2,0,0,0
0,0,0,18,18,18,18,2,109,2,18,18,18
0,0,0,18,0,0,0,2,109,2,0,0,0
0,0,0,18,102,102,102,2,109,2,102,102,102
0,0,0,18,104,18,18,2,109,2,18,18,18
0,0,0,18,104,18,0,2,109,2,0,0,0
0,0,0,18,104,18,0,2,109,2,0,0,0
2,2,2,18,104,18,2,2,109,2,0,0,0
0,0,0,18,104,18,0,0,109,2,0,0,0
101,101,101,18,104,18,101,101,101,2,0,0,0
2,2,2,18,104,18,2,2,2,2,0,0,0
0,0,0,18,104,18,0,0,0,0,0,0,0
0,0,0,18,104,18,0,0,0,0,0,0,0
