0,0,0,0,0,0,0,0,0,0,0,0,0
0,0,0,0,0,0,0,0,0,0,0,0,0
103,0,103,0,103,0,103,0,103,0,103,0,103
19,0,19,0,19,0,19,0,19,0,19,0,19
0,107,0,107,0,107,0,107,0,107,0,107,0
0,19,0,19,0,19,0,19,0,19,0,19,0
106,0,106,0,106,0,106,0,106,0,106,0,106
19,0,19,0,19,0,19,0,19,0,19,0,19
0,104,0,104,0,104,0,104,0,104,0,104,0
0,19,0,19,0,19,0,19,0,19,0,19,0
102,0,102,0,102,0,102,0,102,0,102,0,102
19,0,19,0,19,0,19,0,19,0,19,0,19
0,109,0,109,0,109,0,109,0,109,0,109,0
0,19,0,19,0,19,0,19,0,19,0,19,0
101,0,101,0,101,0,101,0,101,0,101,0,101
19,0,19,0,19,0,19,0,19,0,19,0,19
0,108,0,108,0,108,0,108,0,108,0,108,0
0,19,0,19,0,19,0,19,0,19,0,19,0
0,0,0,0,0,0,0,0,0,0,0,0,0
0,0,0,0,0,0,0,0,0,0,0,0,0
