0,0,0,0,0,0,0,0,0,0,0,0,0
0,0,0,0,0,0,0,0,0,0,0,0,0
0,0,0,0,0,0,0,0,0,0,0,0,0
0,0,0,0,0,0,0,0,0,0,0,0,0
0,0,0,0,0,0,0,0,0,0,0,0,0
0,0,0,0,0,0,0,0,0,0,0,0,0
0,2,2,2,2,2,2,2,2,2,2,2,0
0,2,2,2,2,18,0,18,2,2,2,2,0
0,2,107,0,2,18,2,18,2,0,103,2,0
0,2,2,0,2,18,0,18,2,0,2,2,0
0,2,104,0,2,18,2,18,2,0,106,2,0
0,2,2,0,0,0,18,0,0,0,2,2,0
0,2,109,0,2,18,2,18,2,0,102,2,0
0,2,2,0,2,18,0,18,2,0,2,2,0
0,2,108,0,2,18,2,18,2,0,101,2,0
0,2,2,2,2,18,0,18,2,2,2,2,0
0,2,2,2,2,2,2,2,2,2,2,2,0
