0,0,0,0,0,0,0,0,0,0,0,0,0
0,0,0,0,0,0,0,0,0,0,0,0,0
0,0,0,0,0,0,0,0,0,0,0,0,0
0,0,0,0,0,0,0,0,0,0,0,0,0
0,0,0,0,0,0,0,0,0,0,0,0,0
0,0,0,0,0,2,2,2,0,0,0,0,0
0,0,0,0,0,104,104,104,0,0,0,0,0
0,0,0,0,0,107,107,107,0,0,0,0,0
0,0,0,0,0,101,101,101,0,0,0,0,0
0,0,0,0,0,102,102,102,0,0,0,0,0
0,0,0,0,0,106,106,106,0,0,0,0,0
0,0,0,0,0,2,2,2,0,0,0,0,0
0,0,0,0,0,0,0,0,0,0,0,0,0
0,0,18,0,0,0,18,0,0,0,18,0,0
