0,0,0,0,0,0,0,0,0,0,0,0,0
0,0,0,0,0,0,0,0,0,0,0,0,0
0,0,0,0,0,0,0,0,0,0,0,0,0
2,2,2,2,2,2,2,2,2,2,2,2,2
103,103,103,102,103,103,2,104,104,101,104,104,104
103,103,102,102,103,103,2,104,104,101,101,104,104
103,102,102,102,102,102,2,101,101,101,101,101,104
102,102,102,102,102,102,2,101,101,101,101,101,101
103,102,102,102,102,102,2,101,101,101,101,101,104
103,103,102,102,103,103,2,104,104,101,101,104,104
103,103,103,102,103,103,2,104,104,101,104,104,104
2,2,19,2,2,2,2,2,2,2,19,2,2
